8,8,7,7,5,5,3,3,1,0,1,3,3,5,5,7,7,8,8,
8,7,7,5,5,3,3,1,0,0,0,1,3,3,5,5,7,7,8,
7,7,5,5,3,3,1,0,0,0,0,0,1,3,3,5,5,7,7,
7,5,5,3,3,1,0,0,0,0,0,0,0,1,3,3,5,5,7,
5,5,3,3,1,0,0,0,0,0,0,0,0,0,1,3,3,5,5,
5,3,3,1,0,0,2,3,4,5,4,3,2,0,0,1,3,3,5,
3,3,1,0,0,0,0,2,3,4,3,2,0,0,0,0,1,3,3,
3,1,0,0,0,0,0,0,2,2,2,0,0,0,0,0,0,1,3,
1,0,0,0,0,0,0,0,0,0,0,0,0,0,0,0,0,0,1
